3 3 3 3 3 3 3 3 3 3 3 3 3 3 3 3 3 3 3 3 3 3 3 3 3 3 3 3 3 3 10 3 3 3 3 3 3 3 3 3 3 3 3 3 3 3 3 3 3 3 3 3 3 3 3 3 3 3 3 3 
3 3 3 3 3 3 3 3 3 3 3 3 3 3 3 3 3 3 3 3 3 3 3 3 0 0 0 0 7 2 2 2 7 0 3 3 3 3 3 3 3 3 3 3 3 3 3 3 0 0 0 0 3 3 3 3 3 3 3 3 
3 3 3 3 3 3 3 3 3 3 3 3 3 3 3 3 3 3 3 3 3 3 3 0 0 0 0 0 0 2 2 2 0 0 0 3 3 3 3 3 3 3 3 3 3 0 0 0 0 0 0 0 0 0 0 3 3 3 3 3 
3 3 3 3 3 3 3 0 0 0 0 0 0 3 3 3 3 3 3 3 3 3 0 0 0 0 0 1 0 2 2 2 0 0 0 0 3 3 3 3 3 3 0 0 0 0 0 0 0 0 0 0 0 0 0 0 0 3 3 3 
3 3 3 3 3 3 0 0 0 0 0 0 0 0 0 3 3 3 3 3 3 0 0 0 0 0 0 1 0 0 0 1 0 0 0 0 0 0 0 0 0 0 0 0 0 0 0 0 0 5 0 0 0 6 0 0 5 3 3 3 
3 3 3 3 3 0 0 0 0 0 0 0 0 0 0 0 0 0 0 0 0 0 0 0 0 0 0 1 0 0 1 1 0 0 0 0 0 0 0 0 0 0 0 0 0 6 0 0 0 0 0 0 0 0 0 0 0 3 3 3 
3 3 3 3 0 0 0 0 1 5 0 0 0 0 0 0 0 0 0 0 0 0 6 0 0 0 0 1 0 0 1 0 0 0 0 0 0 0 0 0 4 0 0 0 0 0 1 1 1 8 0 0 0 0 0 0 0 3 3 3 
3 3 3 3 0 0 0 0 1 1 0 0 0 0 4 0 0 0 0 0 0 0 0 0 0 0 0 1 0 0 1 0 0 0 0 4 0 0 0 0 0 1 1 1 1 1 1 0 0 0 0 0 0 0 0 0 3 3 3 3 
3 3 3 0 0 0 0 0 0 0 0 0 0 0 0 0 0 0 0 0 0 0 0 0 0 0 5 1 0 0 1 0 0 0 0 0 0 0 0 1 1 0 0 0 0 0 0 0 1 0 0 0 0 0 0 3 3 3 3 3 
3 3 3 0 0 0 0 1 0 0 0 8 1 1 6 0 0 0 0 0 0 0 0 0 0 0 0 1 0 0 1 0 0 0 0 0 0 0 1 1 0 0 0 0 0 0 0 0 1 0 6 0 0 0 3 3 3 3 3 3 
3 3 3 0 0 0 0 0 0 0 0 0 0 0 1 1 1 1 1 1 0 0 0 0 0 0 0 1 0 0 1 0 5 6 0 0 1 1 0 0 0 0 0 0 0 0 0 1 1 0 0 0 3 3 3 3 3 3 3 3 
3 3 3 0 0 0 0 0 6 0 0 0 0 0 0 0 0 0 0 1 1 1 1 0 0 0 0 1 0 0 1 0 0 0 0 1 0 0 0 0 0 0 0 0 0 0 1 1 0 0 3 3 3 3 3 3 3 3 3 3 
3 3 3 0 0 0 0 0 1 1 0 0 0 0 0 0 0 0 0 0 0 0 1 1 1 0 0 1 0 0 1 0 0 1 1 0 0 0 0 0 0 0 6 0 1 1 1 0 0 0 3 3 3 3 3 3 3 3 3 3 
3 3 3 0 0 0 0 0 1 0 1 1 0 0 0 0 0 0 0 0 6 0 0 0 0 1 0 1 0 1 1 0 1 1 0 0 0 0 0 0 0 0 1 1 0 0 0 0 3 3 3 3 3 3 3 3 3 3 3 3 
3 3 3 0 0 0 0 0 1 4 0 1 1 1 0 0 0 0 0 0 0 0 0 0 4 0 1 1 0 1 0 1 1 0 0 0 0 0 0 0 1 1 0 0 0 0 0 3 3 3 3 3 3 3 3 3 3 3 3 3 
3 3 3 3 0 0 0 0 0 0 0 0 0 1 1 0 0 0 0 0 0 0 0 0 0 0 0 1 0 1 0 0 0 0 0 0 0 0 0 0 1 0 0 0 0 0 0 0 3 3 3 3 3 3 3 3 3 3 3 3 
3 3 3 3 3 0 0 0 1 1 1 0 0 0 1 1 0 0 0 0 0 0 0 0 1 1 1 0 1 1 0 0 4 0 0 0 0 1 1 1 6 0 0 0 0 0 5 0 0 3 3 3 3 3 3 3 3 3 3 3 
3 3 3 3 3 3 0 0 0 0 0 0 0 0 0 0 1 1 0 0 0 0 0 0 1 1 5 1 1 1 9 0 0 0 0 1 1 1 1 0 0 0 0 0 0 0 0 0 0 0 0 3 3 3 3 3 3 3 3 3 
3 3 3 3 3 3 3 0 0 0 0 0 0 0 0 0 6 0 1 0 0 0 0 0 0 0 1 1 1 1 1 0 0 0 1 1 0 0 1 1 1 1 0 0 0 0 0 0 0 0 0 0 3 3 3 3 3 3 3 3 
3 3 3 3 3 3 3 3 0 0 0 0 6 0 0 0 0 0 0 1 1 1 1 0 0 0 1 1 1 1 1 0 0 0 0 0 0 0 0 0 0 0 1 0 0 0 0 0 0 0 0 0 0 0 3 3 3 3 3 3 
3 3 3 3 3 3 3 3 0 0 0 0 0 0 0 0 0 0 0 0 0 0 1 0 0 0 1 1 1 1 0 0 0 0 0 0 0 0 0 0 0 0 0 1 1 0 0 4 0 6 0 0 0 0 0 3 3 3 3 3 
3 3 3 3 3 3 3 0 0 0 0 0 0 0 0 0 0 0 0 0 0 0 0 0 0 0 1 1 1 0 0 0 0 0 0 0 0 0 0 0 0 5 0 0 0 1 0 0 0 0 0 0 0 0 0 3 3 3 3 3 
3 3 3 3 3 0 0 0 0 0 0 0 0 0 0 0 0 0 0 0 0 0 0 0 0 0 0 0 0 1 0 0 1 1 0 0 0 0 0 0 0 0 0 0 0 0 1 0 0 0 0 0 0 0 0 3 3 3 3 3 
3 3 3 3 0 0 0 0 0 0 0 0 1 1 1 0 0 0 0 0 0 0 0 0 0 0 0 0 0 1 0 0 0 0 1 6 0 0 0 0 0 0 0 0 0 0 0 1 1 0 0 0 0 0 0 0 3 3 3 3 
3 3 3 0 0 0 0 0 0 4 1 1 1 0 0 0 0 0 0 0 0 0 0 0 0 0 0 0 0 1 0 0 0 0 0 1 1 0 0 0 0 0 0 0 0 0 0 0 0 1 0 0 0 0 0 0 3 3 3 3 
3 3 0 0 0 0 0 0 0 1 0 0 0 0 0 0 0 0 0 0 0 1 1 1 0 0 5 0 0 1 0 0 0 0 0 0 0 1 1 0 0 0 0 0 0 0 0 0 0 1 0 0 0 0 0 0 3 3 3 3 
3 3 0 0 0 0 0 0 1 0 0 0 0 0 0 0 0 0 1 1 4 1 0 1 1 0 0 0 0 1 0 0 0 0 0 0 0 0 0 1 0 0 0 0 0 6 0 0 0 1 1 6 0 0 0 0 3 3 3 3 
3 0 0 0 0 0 0 1 0 0 0 0 0 6 0 1 1 1 0 0 0 0 0 0 0 0 0 0 0 1 0 0 5 0 0 0 0 0 0 0 1 1 0 0 0 0 0 0 0 0 1 0 0 0 0 0 3 3 3 3 
3 0 0 0 0 5 1 1 0 8 1 0 0 1 1 0 0 0 0 0 0 0 0 0 0 0 0 0 0 1 0 0 0 0 0 0 0 0 0 0 0 0 1 1 0 0 0 8 0 0 0 1 0 0 0 0 3 3 3 3 
3 0 0 0 0 1 1 0 0 1 0 0 1 1 0 0 0 0 0 0 0 0 0 0 0 0 0 0 0 0 1 0 0 0 0 0 0 0 0 0 4 0 0 0 1 0 0 0 0 0 0 0 0 0 0 0 3 3 3 3 
3 0 0 0 0 1 0 1 1 1 1 1 1 0 0 0 0 0 0 0 0 0 0 0 0 0 0 0 7 2 2 2 7 0 0 0 0 0 0 0 0 0 0 0 0 1 0 0 0 0 0 0 0 0 0 0 3 3 3 3 
3 0 0 0 0 0 0 1 1 1 6 0 0 0 0 3 3 3 3 3 3 3 3 3 3 0 0 0 0 2 2 2 0 0 0 0 0 0 0 0 0 0 0 0 0 1 1 0 0 0 0 0 0 0 0 0 3 3 3 3 
3 3 0 0 0 0 0 0 0 0 0 0 0 0 3 3 3 3 3 3 3 3 3 3 3 3 0 0 0 2 2 2 0 0 0 0 0 0 3 3 3 3 3 3 0 0 1 5 1 1 6 0 0 0 0 3 3 3 3 3 
3 3 0 0 0 0 0 0 0 0 0 0 0 3 3 3 3 3 3 3 3 3 3 3 3 3 0 0 0 2 2 2 0 0 0 0 0 3 3 3 3 3 3 3 3 0 0 0 0 0 0 0 0 0 3 3 3 3 3 3 
3 3 3 3 0 0 0 0 0 0 0 3 3 3 3 3 3 3 3 3 3 3 3 3 3 3 3 0 0 2 2 2 0 0 0 0 0 3 3 3 3 3 3 3 3 3 3 0 0 0 0 3 3 3 3 3 3 3 3 3 
3 3 3 3 3 3 3 3 3 3 3 3 3 3 3 3 3 3 3 3 3 3 3 3 3 3 3 0 0 2 2 2 0 0 0 0 0 3 3 3 3 3 3 3 3 3 3 3 3 3 3 3 3 3 3 3 3 3 3 3