3 3 3 3 0 0 0 4 0 0 0 0 0 0 3 3 3 3 3 3 3 3 3 3 3 3 3 3 3 3 10 3 3 3 3 3 3 3 0 5 5 5 5 5 5 5 5 5 5 5 5 5 5 5 5 5 5 5 5 5 
3 3 0 0 0 0 0 0 0 0 0 0 0 0 0 0 3 3 3 3 3 3 3 3 3 3 0 0 7 2 2 2 7 3 3 3 3 0 0 0 5 5 5 5 5 5 5 5 5 5 5 5 5 5 5 5 5 5 5 5 
3 0 0 0 7 2 2 2 2 2 7 0 1 0 0 0 0 0 4 3 3 3 0 0 0 0 0 0 0 2 2 2 0 0 4 0 0 0 0 0 0 5 5 5 5 0 0 0 0 0 0 0 0 0 1 0 5 5 5 5 
0 0 0 0 2 1 1 1 1 1 2 0 0 0 0 0 0 0 0 0 0 0 0 5 0 0 0 1 0 2 2 2 0 0 0 0 6 0 0 0 0 5 5 5 0 0 1 0 0 1 0 6 0 0 0 0 0 0 5 5 
0 0 1 0 2 1 2 2 2 1 2 0 0 6 0 0 5 0 0 0 0 0 0 0 0 0 0 0 0 2 2 2 0 0 0 0 0 0 0 6 0 5 5 5 0 6 0 1 0 5 0 0 0 8 6 0 0 5 5 5 
0 0 6 0 2 1 2 8 2 1 2 0 0 0 0 0 0 0 0 0 1 0 0 0 0 4 0 0 0 1 0 1 0 0 0 1 0 0 0 0 5 5 5 0 0 0 0 0 0 0 0 0 1 0 0 0 0 5 5 5 
0 0 0 0 2 1 2 2 2 1 2 0 0 1 1 0 0 1 0 0 0 1 1 0 0 0 0 0 0 1 0 1 0 0 0 0 1 0 0 0 5 5 5 0 6 0 1 5 0 0 0 1 0 0 5 0 0 0 5 5 
0 0 0 0 2 1 1 1 1 1 2 0 0 0 1 1 1 0 0 6 0 0 1 0 0 0 0 0 0 1 0 1 0 5 0 0 0 0 0 0 5 5 5 0 0 0 0 0 0 1 9 0 0 1 0 0 0 5 5 5 
3 4 0 0 7 2 2 2 2 2 7 0 0 0 0 0 1 0 0 0 0 0 1 1 0 0 0 0 0 1 0 1 0 0 0 0 0 0 0 0 5 5 5 0 0 1 0 6 0 0 0 0 0 0 0 1 0 5 5 5 
3 3 0 0 0 0 0 0 0 0 0 0 0 4 0 0 0 0 0 0 5 0 0 0 0 0 0 0 0 1 0 1 0 0 0 0 6 0 0 0 0 5 5 0 0 0 0 0 0 1 0 0 0 6 0 0 5 5 5 5 
3 3 3 3 0 0 0 0 3 3 3 3 3 3 3 3 3 3 0 0 0 0 0 1 0 0 0 0 0 1 0 1 0 0 0 0 0 0 0 0 0 5 5 0 0 0 0 1 0 0 0 5 1 0 0 5 5 5 5 5 
3 3 3 3 3 3 3 3 3 3 3 3 3 3 3 3 3 3 3 3 0 0 0 0 0 0 0 6 0 1 0 1 0 0 0 0 0 0 0 0 0 0 5 1 0 1 0 1 0 0 0 0 0 0 5 5 5 5 5 5 
3 3 3 3 3 3 3 3 3 3 3 3 3 3 3 3 3 3 3 3 3 0 0 0 0 0 0 0 0 1 0 1 0 0 1 0 4 0 0 0 0 0 0 0 0 0 0 1 1 6 0 0 5 5 5 5 5 5 5 5 
3 3 3 3 3 3 3 3 3 0 0 0 0 0 0 0 4 0 0 0 3 3 0 0 0 0 0 0 0 2 2 2 0 0 0 0 0 0 0 0 6 0 0 0 6 0 0 1 0 0 0 5 5 5 5 5 5 0 0 0 
3 3 3 3 0 0 0 0 0 0 0 0 0 0 0 0 0 1 0 0 0 3 3 0 0 0 0 0 0 2 9 2 0 0 0 0 0 0 0 0 0 0 0 0 0 0 0 0 0 1 0 5 5 5 5 5 0 0 0 0 
3 3 3 0 0 6 0 0 0 0 0 1 1 0 0 0 0 0 0 0 0 0 3 5 0 0 0 0 0 2 2 2 0 0 0 0 0 0 0 0 0 1 1 0 1 0 0 0 1 0 0 0 0 0 0 0 0 0 0 0 
3 3 0 0 0 0 0 0 4 0 0 1 0 0 0 0 0 0 0 0 0 0 0 1 0 0 1 0 0 1 0 1 0 0 0 0 1 0 1 0 0 1 0 0 0 0 6 0 0 0 0 0 0 0 0 6 0 0 0 4 
3 0 0 0 0 0 0 0 0 0 0 0 0 0 0 0 0 0 0 0 0 0 0 0 0 0 0 0 0 1 0 1 6 0 0 0 0 0 0 0 0 1 0 0 0 0 0 0 0 0 0 0 0 0 0 0 0 0 0 0 
3 0 0 0 4 0 0 0 0 0 0 3 3 3 3 3 3 0 0 0 0 0 0 1 0 0 0 0 0 1 0 1 0 0 0 0 0 0 0 5 0 0 0 0 4 0 0 0 0 0 0 0 0 6 0 0 0 0 0 3 
3 0 1 0 0 0 1 0 0 0 0 3 3 3 3 3 3 3 3 3 3 0 3 0 0 0 0 0 0 1 0 1 0 0 0 1 0 0 0 0 0 0 0 0 0 0 0 0 0 0 0 3 3 3 3 3 3 3 3 3 
3 0 0 0 0 0 1 0 0 0 0 3 3 3 3 3 3 3 3 3 3 3 3 0 0 1 0 4 0 1 0 1 0 0 0 0 0 0 1 0 0 0 1 0 1 0 0 0 0 0 3 3 3 3 3 3 3 3 3 3 
3 3 0 0 0 0 0 0 0 0 0 0 0 0 3 3 3 3 3 3 3 3 3 0 0 0 0 0 0 1 0 1 0 5 3 3 3 3 0 0 0 0 0 0 0 0 0 0 0 0 0 3 3 3 3 3 3 3 3 3 
3 3 0 0 0 0 0 4 0 0 0 0 0 0 0 0 0 3 3 3 3 3 3 0 0 0 0 0 0 1 0 1 0 0 3 3 3 3 3 3 3 0 0 0 0 5 0 0 1 0 0 0 0 3 3 3 3 3 3 3 
3 3 3 3 3 3 3 3 3 3 0 0 0 0 0 0 1 0 0 0 0 3 3 0 0 0 0 0 0 1 0 1 0 0 3 3 3 3 3 3 3 3 0 0 0 0 0 1 0 0 0 5 0 4 0 3 3 3 3 3 
3 3 3 3 3 3 3 3 3 3 3 3 3 0 0 0 0 0 0 6 0 3 3 3 0 0 0 0 0 1 0 1 0 0 0 0 0 3 3 3 3 3 3 0 0 0 0 0 0 0 0 0 0 0 0 0 0 3 3 3 
3 3 3 3 3 3 3 0 0 0 3 3 3 3 1 0 0 0 0 0 0 3 3 3 1 0 0 6 0 1 0 1 0 0 1 0 0 6 0 5 3 3 3 3 0 0 0 0 0 0 0 0 0 0 0 0 0 0 3 3 
3 3 3 3 0 0 4 0 0 0 0 0 0 0 0 0 1 0 0 0 0 3 3 3 3 0 0 0 0 1 0 1 0 0 0 0 1 0 0 0 3 3 3 3 3 0 0 0 0 0 0 1 0 1 0 0 0 0 0 3 
3 3 0 0 0 0 0 0 0 0 0 0 0 0 0 0 0 5 0 0 0 3 3 3 3 0 0 0 0 1 0 1 0 0 6 0 0 0 0 0 0 3 3 3 3 0 0 4 0 0 1 0 0 0 0 0 1 0 4 3 
3 0 0 0 0 0 0 0 0 0 4 0 0 0 0 0 1 0 0 0 0 3 3 3 3 0 1 0 0 1 0 1 0 0 0 0 0 0 5 0 0 0 3 3 3 3 0 0 0 0 0 0 0 5 0 0 0 0 0 3 
3 0 0 1 0 0 0 1 0 0 0 0 0 0 0 0 0 0 0 0 0 3 3 3 3 0 0 0 0 1 0 1 0 0 0 0 0 0 0 0 1 0 0 3 3 3 3 0 0 0 0 0 0 0 0 0 0 0 0 3 
3 3 0 0 0 8 0 0 0 0 0 0 0 0 1 0 0 0 0 0 3 3 3 3 3 0 0 0 0 1 0 1 0 0 0 0 1 0 0 0 0 0 0 3 3 3 3 0 5 0 0 0 0 0 0 0 0 1 0 3 
3 3 0 0 0 0 0 0 0 0 0 4 0 0 0 0 0 0 4 3 3 3 3 3 3 3 0 0 0 1 0 1 0 0 0 0 0 1 0 0 0 0 0 3 3 3 3 3 0 0 0 1 0 1 0 8 0 1 0 3 
3 3 0 0 0 0 0 0 0 0 0 0 0 0 0 0 0 3 3 3 3 3 3 3 3 3 0 0 7 2 2 2 7 0 0 0 0 0 0 0 5 0 0 3 3 3 3 3 0 4 0 0 0 1 0 0 0 0 0 3 
3 3 3 0 0 4 0 0 0 0 0 0 0 0 3 3 3 3 3 3 3 3 3 3 3 3 0 0 0 2 2 2 0 0 1 0 0 6 0 0 0 0 3 3 3 3 3 3 3 3 3 0 0 1 0 0 0 0 0 0 
3 3 3 3 3 3 3 3 3 3 3 3 3 3 3 3 3 3 3 3 3 3 3 3 3 3 0 0 0 2 2 2 0 0 0 0 0 3 3 3 3 3 3 3 3 3 3 3 3 3 3 3 0 0 1 0 0 0 4 0 
3 3 3 3 3 3 3 3 3 3 3 3 3 3 3 3 3 3 3 3 3 3 3 3 3 3 0 0 0 2 2 2 0 0 3 3 3 3 3 3 3 3 3 3 3 3 3 3 3 3 3 3 3 3 0 0 5 0 0 0